11111111111111111111111111111111111111
11000000000000000011000000000000000011
11001111001111110011001111110011110011
11000000000000000000000000000000000011
11001111001100111111111100110011110011
11000000001100000011000000110000000011
11111111001111110011001111110011111111
00000011001100000000000000110011000000
11111111001100110033001100110011111111
22000000000000110000001100000000000022
11111111001100111111111100110011111111
00000011001100000000000000110011000000
11111111001100111111111100110011111111
11000000000000000011000000000000000011
11001111001111110011001111110011110011
11000011000000000000000000000011000011
11110011001100111111111100110011001111
11000000001100000011000000110000000011
11001111111111110011001111111111110011
11000000000000000000000000000000000011
11111111111111111111111111111111111111