11111111111111111111111111111111111111
11000000000000000111100000000000000011
11011111011111110111101111111011111011
11000000000000000000000000000000000011
11011111011101111111111110111011111011
11000000011100000111100000111000000011
11111111011111110111101111111011111111
00000011011100000000000000111011000000
11111111011101111111111110111011111111
22000000000001111111111110000000000022
11111111011101111111111110111011111111
00000011011100000000000000111011000000
11111111011101111111111110111011111111
11000000000000000111100000000000000011
11001111011111110111101111111011111011
11000011000000000000000000000011000011
11111011011110111111111110111011011111
11000000011110000011100000111000000011
11011111111111111011101111111111111011
11000000000000000000000000000000000011
11111111111111111111111111111111111111