11111111111111111111111111111111111111
11000000011000001111110000011000000011
11011111000110100000000101100011111011
10011111110000111111111100001111111001
10111111111010000000000001011111111101
10000000000011110111101111000000000001
11011111110000000111100000001111111011
11000000111111111111111111111100000011
11011110000000000111000000000001111011
11011111110111010000011011101111111011
11011100000000011010111000000000111011
11011101111101111010111110111110111011
11011101100000000000000000000110111011
11011001101110111111111101110110011011
11011011101110000000000001110111011011
11011011101111101111110111110111011011
11011000000000001111110000000000011011
11011011101111100000000111110111011011
11011011100011111111111111000111011011
11000000001000000000000000010000000011
11111111111111111111111111111111111111