11111111111111111111111111111111111111
11000000011000000000000000011000000011
11011111011011111111111111011011111011
11000000000000000000000000000000000011
11110110111110111111111101111101101111
11110110111110111111111101111101101111
11000110001110000000000001110001100011
11110111101110111111111101110111101111
11110111101110011111111001110111101111
11110111101111011111111011110111101111
11110111101110011111111001110111101111