21 38
11111111111111111111111111111111111111
11                                  11
11 1111 11 11 1111111111 11 11 1111 11
11 11   11 11    1111    11 11   11 11
11 11 1111    11  11  11    1111 11 11
1       11 11 111    111 11 11      11
11 1111 11 11 1111111111 11 11 1111 11
11 1111    11            11    1111 11
11   11 11 11 1111  1111 11 11 11   11
11      11    1111111111    11      11
1111 11111 11 1111111111 11 11111 1111
1111       11            11       1111
1111 11111111111 1111 11111111111 1111
1    11           11           11    1
1111 11 11111 1111111111 11111 11 1111
11       11                11       11
11 11111 1111111 1111 1111111 11111 11
11 11             11             11 11
11 11 11111111 11111111 11111111 11 11
11                                  11
11111111111111111111111111111111111111